0 1 0 1 2 3 4 5 0 1 2 3 6 7 0 1 2 3 8 9 10 11 12 13 0 1 14 15 2 3 12 13 0 1 14 15 2 3 12 13 0 1 16 17 6 7 18 19
21 22 23 24 2 3 21 22 21 22 2 3 25 25 21 22 2 3 26 27 23 24 21 22 28 29 30 31 2 3 32 33 28 29 30 31 2 3 32 33 28 29 16 34 25 25 35 19
0 1 4 5 2 3 0 1 0 1 2 3 25 25 0 1 2 3 36 37 4 5 0 1 2 3 14 15 2 3 12 13 2 3 14 15 2 3 12 13 2 3 8 9 25 25 18 19
38 39 40 40 40 40 41 42 43 44 2 3 25 25 21 22 2 3 45 46 21 22 21 22 2 3 21 22 2 3 21 22 2 3 21 22 2 3 47 48 2 3 45 46 25 25 49 50
51 51 51 51 51 51 51 52 53 54 2 3 25 25 0 1 2 3 55 56 0 1 0 1 2 3 0 1 2 3 0 1 2 3 0 1 2 3 6 7 2 3 55 56 25 25 49 57
16 34 21 22 28 29 58 59 52 60 40 40 38 39 40 40 40 40 41 42 43 44 21 22 2 3 21 22 2 3 21 22 2 3 21 22 2 3 23 24 2 3 61 62 63 64 49 65
8 9 0 1 2 3 10 11 51 51 51 51 51 51 51 51 51 51 51 52 53 54 0 1 2 3 0 1 2 3 0 1 2 3 0 1 2 3 4 5 2 3 66 63 67 51 51 51
45 46 21 22 2 3 21 22 47 48 2 3 23 24 2 3 23 24 58 59 52 53 43 44 2 3 21 22 2 3 21 22 2 3 21 22 2 3 21 22 2 3 68 67 69 70 35 19
55 56 0 1 2 3 0 1 6 7 2 3 4 5 2 3 4 5 10 11 71 52 53 54 2 3 0 1 2 3 0 1 2 3 0 1 2 3 0 1 2 3 51 77 72 73 18 19
38 39 38 39 74 75 38 39 38 39 74 75 38 39 74 75 38 39 38 39 38 39 52 60 74 75 38 39 74 75 38 39 74 75 38 39 74 75 38 39 74 75 38 39 38 39 76 19
51 51 51 51 51 51 51 51 51 51 51 51 51 51 51 51 51 51 51 51 51 51 51 51 51 51 51 51 51 51 51 51 51 51 51 51 51 51 51 51 51 51 51 51 51 51 51 51
77 77 77 77 77 77 77 77 77 77 77 77 77 77 77 77 77 77 77 77 77 77 77 77 77 77 77 77 77 77 77 77 77 77 77 77 77 77 77 77 77 77 77 77 77 77 77 77
