0 0 0 0 0 0 0 0 0 0 0 0 0 0 0 0 0 0 0 0 0 0 0 0 0 0 0 0 0 0 0 0 0 0 0 0 0 0 0 0 0 1 2 3 2 3 4 5
0 0 7 8 7 8 7 8 7 8 7 8 0 0 0 0 0 0 7 8 7 8 7 8 7 8 7 8 0 0 0 0 0 0 0 0 0 0 0 0 9 10 11 12 11 12 13 5
14 15 14 15 14 15 14 15 14 15 14 15 0 0 0 0 14 15 14 15 14 15 14 15 14 15 14 15 0 0 0 0 0 0 0 0 0 0 0 0 5 5 10 3 10 3 16 5
17 18 17 18 17 18 17 18 17 18 17 18 7 8 7 8 17 18 17 18 17 18 17 18 17 18 17 18 7 8 7 8 7 8 7 8 7 8 7 8 5 19 20 3 20 3 21 5
14 15 22 23 14 15 14 15 14 15 14 15 14 15 14 15 14 15 22 23 14 15 14 15 14 15 14 15 14 15 14 15 14 15 14 15 22 23 22 23 5 10 24 25 10 3 4 5
17 18 26 27 17 18 17 18 17 18 17 18 17 18 17 18 17 18 26 27 17 18 17 18 17 18 17 18 17 18 17 18 17 18 17 18 26 27 26 27 5 1 28 5 20 3 13 5
22 23 5 5 22 23 22 23 22 23 22 23 22 23 22 23 22 23 5 5 22 23 22 23 22 23 22 23 22 23 22 23 22 23 22 23 5 5 5 5 5 10 4 5 10 3 16 5
26 27 29 30 26 27 26 27 26 27 26 27 26 27 26 27 26 27 29 30 26 27 26 27 26 27 26 27 26 27 26 27 26 27 26 27 29 30 5 5 5 1 13 5 20 3 21 5
31 32 33 34 5 5 31 32 31 32 5 5 31 32 5 5 31 32 33 34 5 5 31 32 31 32 5 5 31 32 5 5 5 5 5 5 33 34 5 5 5 1 35 5 1 36 16 5
37 38 39 40 41 41 37 38 37 38 41 41 37 38 41 41 37 38 39 40 41 41 37 38 37 38 41 41 37 38 41 41 41 41 42 43 39 40 44 45 46 47 48 5 48 49 21 5
50 50 50 50 50 50 50 50 50 50 50 50 50 50 50 50 50 50 50 50 50 50 50 50 50 50 50 50 50 50 50 50 50 50 50 50 50 50 50 50 50 50 50 50 50 50 50 50
5 5 5 5 5 5 5 5 5 5 5 5 5 5 5 5 5 5 5 5 5 5 5 5 5 5 5 5 5 5 5 5 5 5 5 5 5 5 5 5 5 5 5 5 5 5 5 5
