0 0 1 2 3 4 5 5 6 7 5 5 8 9 10 11 1 2 1 2 1 2 1 2 5 5 5 5 1 2 5 5 1 2 1 2 5 5 1 2 5 5 1 2 12 13 14 15
0 0 2 17 5 5 4 18 5 5 5 5 8 9 19 20 2 17 21 22 23 24 2 17 25 26 21 22 23 24 27 28 2 17 21 22 23 24 25 26 21 22 23 24 29 30 14 15
0 0 31 2 5 5 3 4 5 5 5 5 8 9 32 33 31 2 12 13 13 34 31 2 6 7 12 13 13 34 10 11 31 2 12 13 13 34 6 7 12 13 13 34 35 36 14 15
0 0 5 5 5 5 5 5 4 18 25 26 8 9 2 17 25 26 13 13 13 13 25 26 2 17 37 13 38 39 19 20 5 5 37 13 13 13 2 17 13 13 13 13 2 17 14 15
0 0 5 5 5 5 5 5 3 4 6 7 8 9 31 2 6 7 40 41 42 39 6 7 31 2 43 13 44 44 32 33 5 5 43 13 45 13 31 2 40 41 42 39 31 2 14 15
0 0 25 26 5 5 0 0 0 0 0 0 8 9 29 30 2 17 29 30 38 39 2 17 25 26 46 13 44 44 2 17 5 5 46 13 46 13 25 26 13 13 44 44 5 5 0 0
0 0 6 7 5 5 1 2 1 2 1 2 8 9 35 36 31 2 35 36 44 44 31 2 6 7 47 13 44 44 31 2 5 5 47 13 47 13 6 7 40 41 44 44 5 5 44 48
0 0 0 0 5 5 25 26 5 5 2 17 8 9 2 17 25 26 6 0 2 17 5 5 5 5 0 0 2 17 25 26 5 5 2 17 2 17 2 17 2 17 5 5 5 5 44 49
0 0 1 2 5 5 6 7 5 5 31 2 8 9 31 2 6 7 1 2 31 2 5 5 5 5 1 2 31 2 6 7 5 5 31 2 31 2 31 2 31 2 5 5 5 5 44 50
0 0 5 5 0 0 0 0 5 5 5 5 8 9 5 5 5 5 5 5 5 5 5 5 5 5 5 5 5 5 5 5 5 5 5 5 5 5 5 5 5 5 0 0 0 0 0 0
0 0 5 5 1 2 1 2 0 0 0 0 0 0 0 0 0 0 0 0 0 0 0 0 0 0 0 0 0 0 0 0 0 0 0 0 0 0 0 0 0 0 0 0 0 0 0 0
44 44 44 44 44 44 44 44 44 44 44 44 44 44 44 44 44 44 44 44 44 44 44 44 44 44 44 44 44 44 44 44 44 44 44 44 44 44 44 44 44 44 44 44 44 44 44 44
