0 1 2 3 4 5 6 7 1 1 4 5 2 3 1 1 6 7 1 1 2 3 6 7 1 1 1 1 2 3 0 0
9 10 11 12 1 1 6 7 13 10 14 15 1 1 1 1 6 7 14 15 1 1 6 7 13 10 14 15 1 1 0 0
16 17 4 5 1 1 6 7 18 19 2 3 1 1 1 1 6 7 2 3 1 1 6 7 18 19 2 3 1 1 0 0
20 21 1 1 14 15 6 7 18 19 1 1 22 23 22 23 6 7 11 12 1 1 6 7 18 19 22 23 1 1 0 0
0 0 1 1 2 3 0 0 0 0 1 1 0 0 0 0 0 0 4 5 1 1 27 0 0 0 0 0 1 1 0 0
0 1 1 1 18 19 6 7 0 0 1 1 1 1 0 0 0 1 22 23 13 10 0 0 11 12 13 10 1 1 0 0
0 1 1 1 0 0 6 7 0 0 1 1 1 1 0 0 0 1 0 0 18 19 0 0 4 5 18 19 24 0 0 0
0 1 14 15 11 12 6 7 0 0 1 1 14 15 0 0 0 1 1 1 18 19 0 0 1 1 25 26 6 7 0 0
0 1 2 3 4 5 6 7 0 0 1 1 2 3 0 0 0 1 1 1 0 0 0 0 1 1 26 1 6 7 0 0
0 1 13 10 1 1 6 7 0 0 1 1 1 1 0 0 0 1 1 1 1 1 1 1 25 26 1 1 6 7 0 0
0 1 18 19 1 1 6 7 0 0 1 1 1 1 0 0 0 1 1 1 1 1 1 1 26 1 1 1 6 7 0 0
27 27 27 27 27 27 27 27 27 27 27 27 27 27 27 27 27 27 27 27 27 27 27 27 27 27 27 27 27 27 27 27
