0 1 2 3 1 1 1 1 4 5 6 7 2 3 0 0
0 1 2 3 1 1 1 1 5 1 9 10 2 3 0 0
0 1 2 3 1 1 4 5 1 1 11 12 2 3 0 0
0 1 2 3 1 1 5 1 1 1 13 14 2 3 0 0
0 0 2 3 4 5 9 10 15 16 1 1 2 3 0 0
0 0 0 0 0 0 0 0 0 0 1 1 2 3 0 0
0 0 2 3 11 12 1 1 1 1 1 1 2 3 0 0
0 0 2 3 13 14 1 1 1 1 17 0 0 0 0 0
18 7 2 3 1 1 1 1 4 5 1 1 6 7 0 0
19 20 2 3 1 1 1 1 5 1 1 1 9 10 0 0
21 22 2 3 9 10 4 5 15 16 15 16 9 10 0 0
0 0 0 0 0 0 0 0 0 0 0 0 0 0 0 0 