0 1 2 3 1 1 1 1 4 1 5 6 2 3 0 0
0 1 2 3 1 1 8 4 1 1 9 10 2 3 0 0
0 1 2 3 1 1 4 1 1 1 11 12 2 3 0 0
0 0 2 3 8 4 5 6 13 14 1 1 2 3 0 0
0 0 0 0 0 0 0 0 0 0 1 1 2 3 23 0
0 0 2 3 9 10 1 1 1 1 1 1 2 3 23 0
0 0 2 3 11 12 1 1 1 1 15 0 0 0 0 0
16 17 2 3 1 1 1 1 8 4 1 1 18 17 0 0
19 20 2 3 1 1 1 1 4 1 1 1 5 6 0 0
21 22 2 3 5 6 8 4 13 14 13 14 5 6 0 0
0 0 0 0 0 0 0 0 0 0 0 0 0 0 0 0
23 23 23 23 23 23 23 23 23 23 23 23 23 23 23 23