0 0 1 2 3 3 3 3 1 2 4 4 4 4 4 4 4 4 4 4 4 4 4 4 4 4 4 4 4 4 4 4 4 4 4 4 4 4 4 4 4 4 4 4 4 4 0 0
0 0 3 3 3 3 6 7 3 3 4 4 4 4 4 4 3 8 3 8 4 4 4 4 4 4 4 4 9 10 4 4 4 4 4 4 4 4 4 4 4 4 3 8 3 8 0 0
0 0 3 3 3 3 11 12 3 3 4 4 4 4 4 4 3 3 3 3 4 4 4 4 4 4 4 4 13 14 4 4 4 4 4 4 4 4 4 4 15 16 3 3 3 3 0 0
0 0 3 3 3 3 2 17 3 3 4 4 4 4 9 10 18 19 20 21 9 10 4 4 4 4 4 4 22 23 3 8 3 8 3 8 3 8 24 16 25 25 6 7 3 3 0 0
0 0 3 3 3 3 1 2 3 3 4 4 4 4 13 14 26 4 4 27 13 14 4 4 4 4 4 4 28 3 3 3 3 3 3 3 3 3 25 25 25 25 11 12 3 3 25 29
0 0 3 3 6 7 22 23 0 0 4 4 20 21 0 0 4 4 4 4 3 3 9 10 9 10 3 8 30 31 3 3 3 3 0 0 32 33 2 17 6 7 3 3 3 3 25 34
0 0 3 3 11 12 28 3 0 0 4 4 4 27 3 3 35 36 4 4 3 3 13 14 13 14 3 3 37 38 0 0 3 3 39 2 40 32 1 2 11 12 3 3 0 0 25 41
0 0 3 3 22 23 3 3 3 3 24 16 24 16 6 7 2 17 2 17 3 3 3 3 22 23 0 0 2 17 9 10 3 3 18 19 20 21 32 33 3 3 3 3 2 17 0 0
0 0 3 3 28 3 3 3 3 3 25 25 25 25 11 12 1 2 1 2 3 3 3 3 28 3 39 2 1 2 13 14 3 3 26 4 4 27 40 32 3 3 0 0 1 2 0 0
0 0 0 0 42 0 6 7 6 7 0 0 0 0 0 0 0 0 0 0 9 10 0 0 3 3 4 4 0 0 3 3 3 3 4 4 9 10 0 0 0 0 3 3 3 3 0 0
0 0 0 0 2 43 11 12 11 12 3 3 39 2 39 2 39 2 3 3 13 14 39 2 3 3 35 36 39 2 0 0 0 0 35 36 13 14 39 2 39 2 3 3 3 3 0 0
25 25 25 25 25 25 25 25 25 25 25 25 25 25 25 25 25 25 25 25 25 25 25 25 25 25 25 25 25 25 25 25 25 25 25 25 25 25 25 25 25 25 25 25 25 25 25 25 5